#############
#####.....###
#####.###..##
#........#..#
#@.OOO..##$.#
#..#....##..#
##..##..#.$.#
###..####.$.#
####........#
#########..##
#############